12 13
***#*********
*************
-----------**
*************
*************
*************
*************
**-**********
**-****------
**-**********
**-****-***$*
**-****-*****