12 13
***$*********
*************
-----------**
*************
*************
*************
*************
**-**********
**-****------
**-**********
**-****-***#*
**-****-*****