33 55
----$--------------------------------------------------
----*---********************---------------------------
--***---*------------------*-------------***********---
--*-****************-------*-------------*---------*---
--*----------------*-------*-------------*---------*---
--*----------------*-------***************-------****--
--******************-------*---------------------*-----
--*----------------*-------*---------------------*-----
--**********-------*-------*---------------***---*-----
--*--------*-------*-------*---------------***---*-----
--*--------*-------*-------***********-----***---*-----
--*--------*-------*-----------------*-----------*-----
--*--------*-------*-----------------*-----------*-----
--***********------*-----------------*-----------*-----
------------*------********----------*************-----
------------*-------------*---------------*-----*------
------------*-------------*---------------*-----*------
------------*-------------*---------------*-----*------
------------*-------------*---------------*-----*------
------------*-------------*---------------*******------
------------*-------------*----------------------------
------------*-------------*----------*************-----
------------***********---*****************------*-----
------------------*---*-------------------*------*-----
-********************-*-------------------*------****--
----------------------*******************-*------*--*--
------------------------------------------*------****--
------------------------------******------*---------*--
------------------------------*----*------*---------*--
---*****************-----******----********----******--
-------------------*-----*----------------*------------
-------------------*******----------------*********----
--------------------------------------------------#----
