49 73
#**----------------------------------------------------------------------
******************-**-*****-*****************-*****-**-**-*****-*****-**-
-------**-**----**-**-**----**----**-------**-**----**-**----**-**----**-
-********-**-********-**-**-**-**-**-**-**************-********-********-
-**----**----**-**-**-**-**-**-**----**-**-**-**-------**-**----**-------
-**-*****-*****-**-*****************-*****-**-********-**-**-**-********-
-**-**----------**----------**----------**----**-------**----**----**----
-**-********-*****-*****-***********-*****-***********-*****-***********-
-**-**----**-**----**----**-**----------**-------**-------**-------**----
-**-**-**-**-*****-********-**-*****-*****-***********-********-**-*****-
-------**-**----**----**-**----**-------**-**----**-**-**-------**-**----
-**-*****-**-********-**-*****-**-*****-**-*****-**-********************-
-**-**-------------**----------**-**-**-**----**-**-------**----**-------
-*****-**************-***********-**-*****-*****-**-*****-**-*****-**-**-
----**----**----**----**-**-**----**----**----------**-**-------**-**-**-
-*****-*****-***********-**-*****-*****-***********-**-*****-**-********-
----**-------**-**-**----**-------------**----**-------**----**----**----
-**-*****-**-**-**-**-*****-*****-*****-**-*****-***********-***********-
-**-**-**-**-**-**----**-------**-**-**-**----**-**-**----**----------**-
-*****-********-**-**-**-***********-**-**-********-*****-*****-**-*****-
----------**-**----**-**-**-**-------------**----**-**-**-------**-**-**-
-***********-**-**-**-**-**-*****-********-*****-**-**-**-**-**-**-**-**-
----------**----**-**----------**-**-**-------**-**-**----**-**-**-**-**-
-********-**-*****-***********-*****-**-**-*****-**-*****-**-**-*****-**-
-**-**-**-------**-**----**----------**-**-**----**-------**-**-------**-
-**-**-**-********-**-**************************-**-**-**-********-*****-
----**-------**-**-**----**-**----**-**-------**-**-**-**-------**-**-**-
-***********-**-**-**-*****-*****-**-**-*****-**-********-*****-*****-**-
-------**----**----------**----------**-**-**-------**-------**----------
-***********-**-***********-**-********-**-********-**-**-********-*****-
----**-**----**-**----**-**-**----------**-------**----**-------**----**-
-*****-**-***********-**-**-**-**-********-**-**-********-**-**-**-*****-
-------**-**-------**----**-**-**----**----**-**-**-**----**-**-**-**----
-**-*****-**-**-*****-********-***********-*****-**-*****-**-**-*****-**-
-**-**-**----**-------**-**-**-------------**----**-**----**-**----**-**-
-**-**-**-**-**-********-**-*****-*****-*****-**-**-**-*****************-
-**----**-**-**----**-**----**-------**-**----**----**-**----**----**----
-********-*****-*****-*****-**-***********-**-***********-**-*****-*****-
----**-------**----**-------**----**-**----**-**-------**-**----------**-
-**-********-**-**-*****-***********-**************-**-*****-********-**-
-**-**----**-**-**-**-------**-------**-**----------**-------------**-**-
-**-**-***********-**-*****-*****-*****-**-*****-********************-**-
-**-**-**-------**-**-**----**-**-------------**-------------**-**-**-**-
-*****-*****-**************-**-**-**-**************-**-**-*****-**-*****-
----**----**-**-------**----------**----**----**----**-**----------**-**-
-********-**-********-**-**-**-**-********-*****-********-********-**-**-
-**----------------**-**-**-**-**-**----**-**----------**-**----**-**----
-*****-**************-********-********-**-*****************-************
----------------------------------------------------------------------**$